................................................................
................................................................
................................................................
................................................................
................................................................
................................................................
................................................................
................................................................
....##........................................................##
....##........................................................##
....##........................................................##
....##...........##...........................................##
....##...........##...........................................##
....##...........##...........................................##
....##...........##...........................................##
....##...........##...........................................##
....##...........##...........................................##
....##...........##...........................................##
....##...........##...........................................##
....##...........##...........................................##
....##...........##...........................................##
....##...........##...........................................##
....##...........##...........................................##
....##...........##...........................................##
....##...........##...........................................##
....##...........##...........................................##
....##...........##...........................................##
....##...........##...........................................##
....##...........##............##.............................##
....##...........##............##.............................##
....##...........##............##.............................##
....##...........##............##.............................##
....##...........##............##.............................##
....##...........##............##.............................##
....##...........##............##.............................##
....##...........##............##.............................##
....##...........##............##.............................##
....##.....S.....##............##.............................##
....##.#########.##............##.............................##
....##...........##............##.............................##
....##...........##............##..#######....................##
....##...........##............##.............................##
....##...........##............##.............................##
....##...........##...P...E....##.............................##
....##...........##.MMMMMMMMMMM##.............................##
....##...........##.#############.............................##
....##...........##............##.............................##
....##...........##............##.............................##
....##...........##............##.............................##
....##...........##............##.............................##
....##...........##............##.............................##
....##...........##............##.............................##
....##...........##............##.............................##
....##...........##............##.............................##
....##...........##............##.............................##
....##...........##............##.............................##
....##...........##............##.............................##
....##...........##............##.............................##
....##...........##............##.............................##
....##...........##............##.............................##
....##...........##............##.............................##
....##...........##............##.............................##
....##...........##............##.............................##
....##...........##............##.............................##
....##...........##............##.............................##
================================================================
================================================================
================================================================
================================================================
================================================================
